NO textures/wall4.png
EA textures/cement-wall.png
SO textures/bricks.png
WE textures/wall3.png
C 35,19,73
F 136,152,178
1111
1S01
1001
1111