NO textures/bricks.png
EA textures/bricks.png
SO textures/bricks.png
WE textures/bricks.png
C 0,0,0
F 0,0,0
1111111111111111111111111
1000001001000000100100001
1000001001000000100100001
1000001001000000100100001
1000001001111110100100001
1000001000000000100100001
1000001000000000100100001
1111111111110000110111111
1000000000000000000000001
1000000000000000000000001
1000000000E00000100000001
1000000000000001000000001
1000000000000000000000001
1111111111110000111111111
1000001000000000100100001
1000001000000000100100001
1000001001111110100100001
1000001001000000100100001
1000001001000000100100001
1000001001000000100100001
1111111111111111111111111
1000000000100010000000001
1000000000100010000000001
1000000000100010000000001
1111111111111111111111111