NO textures/wall4.png
EA textures/wall4.png
SO textures/wall4.png
WE textures/wall4.png
C 35,19,73
F 15,6,40
111111111111111
1111110S0111111
111110000011111
111100000001111
111000000000111
110000101000011
100001101100001
110000101000011
111000000000111
111100000001111
111110000011111
111111000111111
111111111111111