NO textures/jerda1.png
SO textures/jerda1.png
WE textures/jerda1.png
EA textures/jerda1.png
F 235,208,160
C 181,199,242
1111111111111111111111111
1000001001000000100100001
1000001001000000100100001
1000001001000000100100001
1000001001111110100100001
1000001000000000100100001
1000001000000000100100001
1111111111110000111111111
1000000000000000000000001
1000000000000000000000001
1000000000000000100000001
1000000000000000D0E000001
1000000000000000100000001
1111111111110000111111111
1000001000000000100100001
1000001000000000100100001
1000001001111110100100001
1000001001000000100100001
1000001001000000100100001
1000001001000000100100001
1111111111111111111111111
1000000000100010000000001
1000000000100010000000001
1000000000100010000000001
1111111111111111111111111