F 3,22,2
C 3,22,2

NO textures/image.png
SO textures/image.png
WE textures/image.png
EA textures/image.png

1111111111111111111
1001001001001001001
1001001001001001001
1001001001001001001
1001000100001001001
1000000000000000001
1000011111111000001
1111000000000001111
1000N00101010000001
1111111111111111111
