SO textures/jerda1.png                    
NO textures/jerda1.png
WE textures/jerda1.png
EA textures///jerda1.png

F 0,0,0
C 0,0,0

111111111111111111
100E001          1
111111111111111111