NO
SO textures/jerda1.png
NO textures/jerda1.png
WE textures/jerda1.png
EA textures/jerda1.png
F 0,0,0
C 0,0,0



11111111111111111111
10000010000000000001
10111101111111111011
10100000000000001001
10101111111111101011
10101000000000101001
10101011111110101111
10101010000010100001
10101010111110111101
10101010100010000101
10101010101111111101
10101010100000000001
10101011111111111111
10101000000000000001
1D101111111011111101
1N000000001000000001
11111111101011111111
10000000000000000001
10111111111111111011
10000000000000000001
11111111111111111111