F 0,0,0
C 0,0,0

NO textures/wall4.png
SO textures/wall4.png
WE textures/wall4.png
EA textures/wall4.png

1111111111111111111
1001001001001001001
1001001001001001001
1001001001001001001
1001000100001001001
1000000000000000001
1000011111111000001
1111000000000001111
10E0000101010000001
1111111111111111111
