NO textures/wall4.png
EA textures/cement-wall.png
SO textures/bricks.png
WE textures/wall3.png
C 35,19,73
F 136,152,178
111111111111111
111111000111111
111110000011111
111100000001111
111000000000111
110000000000011
100000010000001
110000000000011
1110000N0000111
111100000001111
111110000011111
111111000111111
111111111111111